slug	dropdown	singular	plural
almonds	Almonds	Almond	Almonds
animal-products	Animal products	Animal product	Animal products
animal-fats	Animal fats	Animal fat	Animal fats
apples	Apples	Apple	Apples
apricots	Apricots	Apricot	Apricots
aquatic-plants	Aquatic plants	Aquatic plant	Aquatic plants
artichokes	Artichokes	Artichoke	Artichokes
asparagus	Asparagus	Asparagus	Asparagus
avocados	Avocados	Avocado	Avocados
bananas	Bananas	Banana	Bananas
barley	Barley	Barley	Barley
beans	Beans	Bean	Beans
beans-dry	Beans, dry	Dry beans	Dry bean
beans-green	Beans, green	Green bean	Green beans
beef-and-buffalo-meat	Beef and Buffalo Meat	Beef and Buffalo Meat	Beef and Buffalo Meat
beer	Beer	Beer	Beer
beeswax	Beeswax	Beeswax	Beeswax
beverages-alcoholic	Beverages, Alcoholic	Alcoholic beverage	Alcoholic beverages
beverages-fermented	Beverages, Fermented	Fermented beverage	Fermented beverages
blueberries	Blueberries	Blueberry	Blueberries
beef	Beef	Beef	Beef
brazil-nuts-with-shell	Brazil nuts, with shell	Brazil nut	Brazil nuts
buckwheat	Buckwheat	Buckwheat	Buckwheat
butter-ghee	Butter, Ghee	Butter and ghee	Butter and ghee
cabbages	Cabbages	Cabbage	Cabbages
canary-seed	Canary seed	Canary seed	Canary seeds
carrots-and-turnips	Carrots and turnips	Carrot and turnip	Carrots and turnips
cashew-nuts	Cashew nuts	Cashew nut	Cashew nuts
cassava	Cassava	Cassava	Cassava
castor-oil-seed	Castor oil seed	Castor oil seed	Castor oil seeds
cauliflowers-and-broccoli	Cauliflowers and broccoli	Cauliflower and broccoli	Cauliflowers and broccoli
cephalopods	Cephalopods	Cephalopod	Cephalopods
cereals	Cereals	Cereal	Cereals
cherries	Cherries	Cherry	Cherries
chick-peas	Chick peas	Chick pea	Chick peas
citrus-fruit	Citrus fruit	Citrus fruit	Citrus fruit
cocoa-beans	Cocoa beans	Cocoa bean	Cocoa beans
coconut-oil	Coconut oil	Coconut oil	Coconut oil
coconuts	Coconuts	Coconut	Coconuts
coffee	Coffee	Coffee	Coffee
coffee-green	Coffee, green	Green coffee	Green coffee
cottonseed	Cottonseed	Cottonseed	Cottonseeds
cottonseed-oil	Cottonseed oil	Cottonseed oil	Cottonseed oil
cow-peas	Cow peas	Cow pea	Cow peas
cream	Cream	Cream	Cream
crustaceans	Crustaceans	Crustacean	Crustaceans
cucumbers-and-gherkins	Cucumbers and gherkins	Cucumber and gherkin	Cucumbers and gherkins
dates	Dates	Date	Dates
demersal-fish	Demersal Fish	Demersal Fish	Demersal Fish
eggplants	Eggplants	Eggplant	Eggplants
eggs	Eggs	Egg	Eggs
fibre-crops	Fibre crops	Fibre crop	Fibre crops
figs	Figs	Fig	Figs
fish-body-oil	Fish, Body Oil	Fish Body Oil	Fish Body Oil
fish-liver-oil	Fish, Liver Oil	Fish Liver Oil	Fish Liver Oil
fish-and-seafood	Fish and seafood	Fish and seafood	Fish and seafood
flax-fibre	Flax fibre	Flax fibre	Flax fibre
freshwater-fish	Freshwater fish	Freshwater fish	Freshwater fish
fruit	Fruit	Fruit	Fruit
total	Total	Total food	All foods
grapefruit	Grapefruit	Grapefruit	Grapefruits
grapes	Grapes	Grapes	Grapes
groundnut-oil	Groundnut Oil	Groundnut Oil	Groundnut Oil
groundnuts	Groundnuts	Groundnut	Groundnuts
hazelnuts	Hazelnuts	Hazelnut	Hazelnuts
hempseed	Hempseed	Hempseed	Hempseeds
honey	Honey	Honey	Honey
kiwi	Kiwi	Kiwi	Kiwi
lemons-and-limes	Lemons and limes	Lemon and lime	Lemons and limes
lemons-limes-and-products	Lemons, Limes and products	Lemon, Lime and product	Lemons, Limes and products
lentils	Lentils	Lentil	Lentils
lettuce	Lettuce	Lettuce	Lettuce
maize	Maize	Maize	Maize
maize-germ-oil	Maize Germ Oil	Maize Germ Oil	Maize Germ Oil
mangoes	Mangoes	Mango	Mangoes
meat	Meat	Meat	Meat
meat-indigenous	Meat indigenous	Indigenous meat	Indigenous meat
meat-aquatic-mammals	Meat, Aquatic Mammals	Aquatic mammal meat	Aquatic mammal meat
meat-poultry	Meat, Poultry	Poultry meat	Poultry meat
meat-total	Meat, Total	Total meat	All meat
meat-ass	Meat, ass	Ass meat	Ass meat
meat-buffalo	Meat, buffalo	Buffalo meat	Buffalo meat
meat-camel	Meat, camel	Camel meat	Camel meat
meat-cattle	Meat, cattle	Cattle meat	Cattle meat
meat-chicken	Meat, chicken	Chicken meat	Chicken meat
meat-duck	Meat, duck	Duck meat	Duck meat
meat-game	Meat, game	Game meat	Game meat
meat-goat	Meat, goat	Goat meat	Goat meat
meat-goose-and-guinea-fowl	Meat, goose and guinea fowl	Goose and guinea fowl meat	Goose and guinea fowl meat
meat-horse	Meat, horse	Horse meat	Horse meat
meat-mule	Meat, mule	Mule meat	Mule meat
meat-pig	Meat, pig	Pig meat	Pig meat
meat-rabbit	Meat, rabbit	Rabbit meat	Rabbit meat
meat-sheep	Meat, sheep	Sheep meat	Sheep meat
meat-turkey	Meat, turkey	Turkey meat	Turkey meat
melonseed	Melonseed	Melonseed	Melonseeds
milk-excluding-butter	Milk, excluding butter	Milk	Milk
millet	Millet	Millet	Millet
mushrooms	Mushrooms	Mushroom	Mushrooms
mustard-seed	Mustard seed	Mustard seed	Mustard seeds
mutton-and-goat-meat	Mutton and goat meat	Mutton and goat meat	Mutton and goat meat
nuts	Nuts	Nut	Nuts
oats	Oats	Oat	Oats
offals	Offals	Offal	Offals
offals-edible	Offals, edible	Edible offal	Edible offals
oil-palm-fruit	Oil palm fruit	Palm fruit oil	Palm fruit oil
oil-palm	Oil, palm	Palm oil	Palm oil
oilcrops	Oilcrops	Oilcrop	Oilcrops
olive-oil	Olive Oil	Olive Oil	Olive Oil
olives	Olives	Olive	Olives
onions	Onions	Onion	Onions
oranges	Oranges	Orange	Oranges
palm-oil	Palm Oil	Palm Oil	Palm Oil
palm-kernels	Palm kernels	Palm kernel	Palm kernels
palmkernel-oil	Palmkernel Oil	Palmkernel Oil	Palmkernel Oil
papayas	Papayas	Papaya	Papayas
peaches-and-nectarines	Peaches and nectarines	Peach and nectarine	Peaches and nectarines
pears	Pears	Pear	Pears
peas	Peas	Pea	Peas
peas-dry	Peas, dry	Dry pea	Dry peas
peas-green	Peas, green	Green pea	Green peas
pelagic-fish	Pelagic Fish	Pelagic Fish	Pelagic Fish
pigeon-peas	Pigeon peas	Pigeon pea	Pigeon peas
pigmeat	Pigmeat	Pigmeat	Pigmeat
pineapples	Pineapples	Pineapple	Pineapples
plantains	Plantains	Plantain	Plantains
plums	Plums	Plum	Plums
poppy-seed	Poppy seed	Poppy seed	Poppy seeds
potatoes	Potatoes	Potato	Potatoes
poultry-meat	Poultry Meat	Poultry Meat	Poultry Meat
pulses	Pulses	Pulse	Pulses
quinoa	Quinoa	Quinoa	Quinoa
rape-and-mustard-oil	Rape and mustard oil	Rape and mustard oil	Rape and mustard oil
rape-and-mustardseed	Rape and mustardseed	Rape and mustardseed	Rape and mustardseeds
raspberries	Raspberries	Raspberry	Raspberries
rice	Rice	Rice	Rice
roots-and-tubers	Roots and tubers	Root and tuber	Roots and tubers
rubber	Rubber	Rubber	Rubber
rye	Rye	Rye	Rye
safflower-seed	Safflower seed	Safflower seed	Safflower seeds
cotton	Cotton	Cotton	Cotton
sesame-seed	Sesame seed	Sesame seed	Sesame seeds
sesameseed-oil	Sesameseed oil	Sesameseed oil	Sesameseed oil
sheep-and-goat-meat	Sheep and goat meat	Sheep and goat meat	Sheep and goat meat
sorghum	Sorghum	Sorghum	Sorghum
soybean-oil	Soybean oil	Soybean oil	Soybean oil
soybeans	Soybeans	Soybean	Soybeans
starchy-roots	Starchy roots	Starchy root	Starchy roots
stimulants	Stimulants	Stimulant	Stimulants
strawberries	Strawberries	Strawberry	Strawberries
sugar-raw-equivalent	Sugar (raw equivalent)	Sugar	Sugar
sugar-beet	Sugar beet	Sugar beet	Sugar beet
sugar-cane	Sugar cane	Sugar cane	Sugar cane
sunflower-seed	Sunflower seed	Sunflower seed	Sunflower seeds
sunflowerseed-oil	Sunflowerseed Oil	Sunflowerseed Oil	Sunflowerseed Oil
sweet-potatoes	Sweet potatoes	Sweet potato	Sweet potatoes
tea	Tea	Tea	Tea
tobacco	Tobacco	Tobacco	Tobacco
tomatoes	Tomatoes	Tomato	Tomatoes
treenuts	Treenuts	Treenut	Treenuts
vegetable-oils	Vegetable Oils	Vegetable Oil	Vegetable Oils
vegetables	Vegetables	Vegetable	Vegetables
plant-based-foods	Plant-based foods	Plant-based food	Plant-based foods
walnuts	Walnuts	Walnut	Walnuts
watermelons	Watermelons	Watermelon	Watermelons
wheat	Wheat	Wheat	Wheat
wine	Wine	Wine	Wine
wool	Wool	Wool	Wool
yams	Yams	Yam	Yams
